$$$$$$$$$$$$$$$$#$$$$$$$$$$$$$$$$$$$
$$$$$$$$$$$$$$$$#$$$$$$$$$$$$$$$$$$$
$$$$$$$$$$$$$$$$d$$$$$$$$$$$$$$$$$$$
$$$$$$$$$$$$$$$$#$$$$$$$$#$$$$$$$$$$
$$$$$$$$$&$$$####$$$$$$###$$$$$$$$$$
$$$$$$$$$###$#$$$$$$#$$#$$$$$$$$$$$$
$$$$$$$$$#$#$#$$$$$$#$$#$$$#$$$$$$$$
$$$$$$$$$#$#####$$$$####$$$$$$$$$$$$
$$$$$$$$$#$$$#$$$$$##$$#$$$$$$$$$$$$
$$$$$$$$$#$$$#$$####$$$#$$$#$$$$$$$$
$$$$$$$$$#$$$#$$#$$#$$$#####$$$$$$$$
$$$$$$$$$########$$##$$#$$$$$$$$$$$$
$$$$$$$$$#$$$#$$$$$#$$$p$$$$$$$$$$$$
$$$$$$$$$$$$$$$$$$$$$$$$$$$$$$$$$$$$
$$$$$$$$$$$$$$$$$$$$$$$$$$$$$$$$$$$$
$$$$$$$$$$$$$$$$$$$$$$$$$$$$$$$$$$$$
$$$$$$$$$$$$$$$$$$$$$$$$$$$$$$$$$$$$