$$$$$$$$#$$$$$$$$#$$
$&$$$####$$$$$$###$$
$###$#$$$$$$#$$#$$$$
$#$#$#$$$$$$#$$#$$$#
$#$#####$$$$####$$$$
$#$$$#$$$$$##$$#$$$$
$#$$$#$$####$$$#$$$#
$#$$$#$$#$$#$$$#####
$########$$##$$#$$$$
$#$$$#$$$$$#$$$p$$$$