$$$$$$$$$$$$$$$$$$$$$$$$$$$$$$$$$$$$
$$$$$$$$$$$$$$$$#$$$$$$$$$$$$$$$$$$$
$$$$$$$$$$$$$$$$d$$$$$$$$$$$$$$$$$$$
$$$$$$$$$$$$$$$$###$$$$$$$$$$$$$$$$$
$$$$$$$$$#$$$####$###$$###$$$$$$$$$$
$$$$$$$$$###$#$&$$$$#$$#$$$$$$$$$$$$
$$$$$$$$$#$#$#$$$$$$#$$#$$$#$$$$$$$$
$$$$$$$$$#$#####$$$$######$$$$$$$$$$
$$$$$$$$$#$$$#$$$$$##$$#$$$$$$$$$$$$
$$$$$$$$$#$$$#$$####$$$#$$#$$$$$$$$$
$$$$$$$$$#$$$####$$#$$$#####$$$$$$$$
$$$$$$$$$######$#$$##$$#$$#$$$$$$$$$
$$$$$$$$$#$$$#$$p$$#$$$$$$#$$$$$$$$$
$$$$$$$$$$$$$$$$$$$$$$$$$$$$$$$$$$$$
$$$$$$$$$$$$$$$$$$$$$$$$$$$$$$$$$$$$
$$$$$$$$$$$$$$$$$$$$$$$$$$$$$$$$$$$$