$$$$$$$$$$$$$$$$$$$$$$$$$$$$$$$$$$$$
$$$$$$$$$$$$$$$$$$$$$$$$$$$$$$$$$$$$
$$$$$$$$$$$$$$$$#$$$$$$$$#$$$$$$$$$$
$$$$$$$$$&$$$####$$$$$$###$$$$$$$$$$
$$$$$$$$$###$#$$$$$$#$$#$$$$$$$$$$$$
$$$$$$$$$#$#$#$$$$$$#$$p$$$#$$$$$$$$
$$$$$$$$$#$#####$$$$####$$$$$$$$$$$$
$$$$$$$$$#$$$#$$$$$##$$#$$$$$$$$$$$$
$$$$$$$$$#$$$#$$####$$$#$$$#$$$$$$$$
$$$$$$$$$#$$$#$$#$$#$$$#####$$$$$$$$
$$$$$$$$$########$$##$$#$$$$$$$$$$$$
$$$$$$$$$#$$$#$$$$#$#$$$$$$$$$$$$$$$
$$$$$$$$$d$$$$$$$$$$$$$$$$$$$$$$$$$$
$$$$$$$$$#$$$$$$$$$$$$$$$$$$$$$$$$$$
$$$$$$$$$#$$$$$$$$$$$$$$$$$$$$$$$$$$
$$$$$$$$$#$$$$$$$$$$$$$$$$$$$$$$$$$$