$$$$$$$$$$$$$$$$$$$$$$$$$$$$$$$$$$$$$$$$$$$$$$$$
$$$$$$$$$$$$$$$$$$$$$$$$$$$$$$$$$$$$$$$$$$$$$$$$
$$$$$#$$$$$$$$$$$$$$$$$$$$$$$$$$$$$$$$$$$$$$$$$$
$$$$$$$$$#$$#$$$#$$$$#$$$#####$$$$$$$$$$$$$$$$$$
$$$$$&$$$########$$###$##&$$$#######$$$###$$$$$$
$$$$$###$#$$$#$$#$$#$$$#$$$$$####$$#$$$###$$$$$$
$$$$$#$#$#$$$#$$#$$#$$$#$$$$$#$$#$$#$$$###$$$$$$
$$$$$#$#####$###########$$$$$#$$#$$###$###$$$$$$
$$$$$#$$$#$###$#$$$p$$$$$$$$$####$$$$$$###$$$$$$
$$$$$d$$$#$$####$$$$$$$$$$$$$$$$$$$$$$$$$$$$$$$$
$$$$$#$$$$$$$$$$$$$$$$$$$$$$$$$$$$$$$$$$$$$$$$$$
$$$$$#$$$$$$$$$$$$$$$$$$$$$$$$$$$$$$$$$$$$$$$$$$
$$$$$#$$$$$$$$$$$$$$$$$$$$$$$$$$$$$$$$$$$$$$$$$$
$$$$$#$$$$$$$$$$$$$$$$$$$$$$$$$$$$$$$$$$$$$$$$$$