$$$$$$$$$$$$$$$$$$$$$$$$$$$$$$$$$$$$$$$$$$$$$$$$$$$$$$$$$$$$
$$$$$$$$$$$$$$$$$$$$$$$$$$$$$$$$$$$$$$$$$$$$$$$$$$$$$$$$$$$$
$$$$$$$$$$$$$$$$$$d$$$$$$$$$$$$$$$$$$$$$$$$$$$$$$$$$$$$$$$$$
$$$$$$$$$$$$$$$$$$#$$$$$$$$#$$$###$#$$$$$$#$$$$$$$$$$$$$$$$$
$$$$$$$$$$$&$$$####$$$$$$#######$#$#$$$$$$#$$#$$$#$$$$$$$$$$
$$$$$$$$$$$###$#$$$$$$#$$#$$$$$#$$$#$$$$$##$$#$$$$$$$$$$$$$$
$$$$$$$$$$$#$#$#$$$$$$#$$$$$$#$#$$$#$$#$$#########$$$$$$$$$$
$$$$$$$$$$$#$#####$$$$####$$$$$############$$#$$$$$$$$$$$$$$
$$$$$$$$$$$#$$$#$$$$$##$$#$$$$$#$$$#$$$$$#$$$$$$$$$$$$$$$$$$
$$$$$$$$$$$#$$$#$$####$$$#$$$###$$$#$$#$$#$$$#####$$$$$$$$$$
$$$$$$$$$$$#$$$#$$#$$#$$$#####$########$$##$$#$$$$$$$$$$$$$$
$$$$$$$$$$$########$$##$$#$$$$$#$$$#$$$$$##$$#$$$$$$$$$$$$$$
$$$$$$$$$$$#$$$#$$$$$#$$$$$$$$$#$$$#$$$$$p$$$$$$$$$$$$$$$$$$
$$$$$$$$$$$$$$$$$$$$$$$$$$$$$$$$$$$$$$$$$$$$$$$$$$$$$$$$$$$$
$$$$$$$$$$$$$$$$$$$$$$$$$$$$$$$$$$$$$$$$$$$$$$$$$$$$$$$$$$$$
$$$$$$$$$$$$$$$$$$$$$$$$$$$$$$$$$$$$$$$$$$$$$$$$$$$$$$$$$$$$