$$$$$$$$$$$$$$$$$$$$$$$$$$$$$$$$$$$$$$$$$$$$$$$$$$$$$$$$$$$$
$$$$$$$$$$$$$$$$$$$$$$$$$$$$$$$$$$$$$$$$$$$$$$$$$$$$$$$$$$$$
$$$$$$$$$$$$$$$$$$$$$$$$$$$$$$$$$$$$$$$$$$$$$$$$$$$$$$$$$$$$
$$$$$$$$$$$$$$$$$$$$$$$$$$$$$$$$$$$$$$$$$$$$$$$$$$$$$$$$$$$$
$$$$$$$$$$$$$$$$$#$$$$$$$$#$$$###$#$$$$$$#$$#$$$$$$$$$$$$$$$
$$$$$$$$$$&$$$####$$$##########$#$#$$$$$$#$$#$$$#$$$$$$$$$$$
$$$$$#d######$#$$$$$$#$$#$$$$$#$$$#$$$$$##$$#$$$$$$$$$$$$$$$
$$$$$$$$$$#$#$#$$$$$$#$$$$$$#$#$$$#$$#$$#########$$$$$$$$$$$
$$$$$$$$$$#$#####$$$$####$$$#$############$$#$$$$$$$$$$$$$$$
$$$$$$$$$$#$$$#$$$$$##$$#####$#$$$#$$$$$#$$$$$$$$$$$$$$$$$$$
$$$$$$$$$$#$$$#$$####$$$#$$$###$$$#$$#$$#$$$#####$$$$$$$$$$$
$$$$$$$$$$#$$$#$$#$$#$$$#####$########$$##$$#$$$$$$$$$$$$$$$
$$$$$$$$$$########$$##$$#$$$$$#$$$#$$$$$##$$#$$$$$$$$$$$$$$$
$$$$$$$$$$#$$$#$$$$$#$######$$#$$$#$$$$$p$$$$$$$$$$$$$$$$$$$
$$$$$$$$$$$$$$$$$$$$$$$$$$$$$$$$$$$$$$$$$$$$$$$$$$$$$$$$$$$$
$$$$$$$$$$$$$$$$$$$$$$$$$$$$$$$$$$$$$$$$$$$$$$$$$$$$$$$$$$$$
$$$$$$$$$$$$$$$$$$$$$$$$$$$$$$$$$$$$$$$$$$$$$$$$$$$$$$$$$$$$
$$$$$$$$$$$$$$$$$$$$$$$$$$$$$$$$$$$$$$$$$$$$$$$$$$$$$$$$$$$$